#separator:tab
#html:false
In het weekend ga ik naar de bioscoop.	На выходных я иду в кино. (in het weekend)
Op zaterdag ga ik naar de markt.	В субботу я иду на рынок. (op + день)
Om acht uur begint de film.	В восемь часов начинается фильм. (om + время)
Volgende week is het 20 april.	На следующей неделе будет 20 апреля. (volgende = будущее)
Vorige week was het 6 april.	На прошлой неделе было 6 апреля. (vorige = прошлое)
Wij lunchen meestal tussen 12 en 1 uur.	Мы обычно обедаем между 12 и 1 часом. (tussen...en)
Ik drink bijna altijd wijn bij het eten.	Я почти всегда пью вино за едой. (altijd = всегда)
Ik drink bijna nooit wijn bij het eten.	Я почти никогда не пью вино за едой. (nooit = никогда)
De trein vertrekt om 8.45 uur van spoor 5.	Поезд отправляется в 8.45 с платформы 5. (om + время)
Twee jaar geleden is Mila naar Nederland gekomen.	Два года назад Мила приехала в Нидерланды. (geleden = назад)
De zomervakantie is in de maanden juli en augustus.	Летние каникулы в июле и августе. (in + месяцы)
Ik werk meestal tot vijf uur, maar soms moet ik overwerken.	Я обычно работаю до пяти, но иногда приходится перерабатывать. (soms = иногда)
Vorige maand is hij gestopt met zijn studie.	В прошлом месяце он бросил учёбу. (vorige + прошлое)
Op zaterdag krijgen wij vaak bezoek van vrienden.	В субботу к нам часто приходят друзья. (op + день недели)
Aanstaande maandag begint het nieuwe schooljaar.	В ближайший понедельник начинается новый учебный год. (aanstaande = ближайший)
Ga jij regelmatig tennissen?	Ты регулярно играешь в теннис? (regelmatig = регулярно)
Ja, ik tennis drie keer per week.	Да, я играю в теннис три раза в неделю.
Over twee weken begint de zomervakantie.	Через две недели начинаются летние каникулы. (over = через)
Vorig weekend zijn we naar Parijs geweest.	В прошлые выходные мы были в Париже. (vorig + het weekend)
De lente begint op 21 maart.	Весна начинается 21 марта. (op + дата)
Om hoe laat vertrekt de trein?	Во сколько отправляется поезд? (om = для времени)
De trein vertrekt om kwart over acht.	Поезд отправляется в четверть девятого. (om + время)
Op welke dag heb je les?	В какой день у тебя урок? (op + день)
Ik heb les op maandag en woensdag.	У меня уроки в понедельник и среду. (op + дни)
In welke maand is je verjaardag?	В каком месяце твой день рождения? (in + месяц)
Mijn verjaardag is in juni.	Мой день рождения в июне. (in + месяц)
Op welke datum ben je jarig?	Какого числа у тебя день рождения? (op + дата)
Ik ben jarig op 15 juni.	У меня день рождения 15 июня. (op + дата)
In de zomer ga ik op vakantie.	Летом я еду в отпуск. (in + сезон)
In de winter is het koud.	Зимой холодно. (in + сезон)
Hoe lang geleden was dat?	Как давно это было? (geleden = назад)
Dat was drie maanden geleden.	Это было три месяца назад. (geleden)
Afgelopen zondag was ik ziek.	В прошлое воскресенье я болел. (afgelopen = недавно прошедший)
Komend weekend ga ik naar Amsterdam.	В эти выходные я еду в Амстердам. (komend = ближайший)
Volgende maand begin ik met een nieuwe cursus.	В следующем месяце я начинаю новый курс. (volgende = следующий)
Over een uur ben ik klaar.	Через час я буду готов. (over = через)
Over hoeveel tijd kom je?	Через сколько ты придёшь? (over = через)
Ik kom over een half uur.	Я приду через полчаса. (over = через)
De winkel is open van 9 tot 6.	Магазин открыт с 9 до 6. (van...tot)
Ik werk van maandag tot en met vrijdag.	Я работаю с понедельника по пятницу включительно. (tot en met = включительно)
Tussen 12 en 1 is de administratie gesloten.	С 12 до 1 администрация закрыта. (tussen...en)
Ik bel je tussen vijf en zes.	Я позвоню тебе между пятью и шестью. (tussen...en)
Volgend jaar wil ik naar Spanje.	В следующем году я хочу поехать в Испанию. (volgend + het jaar)
Vorig jaar was ik in Italië.	В прошлом году я был в Италии. (vorig + het jaar)
A.s. vrijdag is de deadline.	В ближ. пятницу дедлайн. (a.s. = aanstaande)
Ik sport regelmatig, drie keer per week.	Я регулярно занимаюсь спортом, три раза в неделю. (regelmatig)
Ik ga soms naar de sportschool.	Я иногда хожу в спортзал. (soms = иногда)
Ik ga nooit naar de opera.	Я никогда не хожу в оперу. (nooit = никогда)
Ik ga altijd met de fiets naar mijn werk.	Я всегда езжу на работу на велосипеде. (altijd = всегда)