#separator:tab
#html:false
#tags column:3
Hallo!	Привет!	link::thema1::taak4::lezen
Ik ben Saïda Turunc.	Я Саида Турунч.	link::thema1::taak4::lezen
Ik ben de nieuwe buurvrouw.	Я новая соседка.	link::thema1::taak4::lezen
Ik kom uit Turkije.	Я из Турции.	link::thema1::taak4::lezen
Ik woon vijf maanden in Nederland.	Я живу в Нидерландах пять месяцев.	link::thema1::taak4::lezen
Ik woon twee weken in mijn nieuwe huis.	Я живу в моём новом доме две недели.	link::thema1::taak4::lezen
Ik woon in de Rijnstraat, op nummer 15.	Я живу на Рейнстраат, дом 15.	link::thema1::taak4::lezen
Ik heb Nederlandse les.	У меня уроки нидерландского.	link::thema1::taak4::lezen
Ik werk in het weekend in een restaurant in de Eikenlaan.	Я работаю в выходные в ресторане на Эйкенлан.	link::thema1::taak4::lezen
Ik ben niet getrouwd.	Я не замужем.	link::thema1::taak4::lezen
Ik heb ook geen kinderen.	У меня тоже нет детей.	link::thema1::taak4::lezen
Ik ben niet alleen.	Я не одна.	link::thema1::taak4::lezen
Ik woon met mijn poes.	Я живу с моей кошкой.	link::thema1::taak4::lezen
Ze heet Shiba en ze is oud.	Её зовут Шиба, и она старая.	link::thema1::taak4::lezen
Ze is 12 jaar!	Ей 12 лет!	link::thema1::taak4::lezen
Ik ben nog niet oud.	Я ещё не старая.	link::thema1::taak4::lezen
Ik ben 27.	Мне 27.	link::thema1::taak4::lezen
Ik hou van koken en sporten.	Я люблю готовить и заниматься спортом.	link::thema1::taak4::lezen
Dat zijn mijn hobby's.	Это мои хобби.	link::thema1::taak4::lezen
Wie zijn jullie?	Кто вы?	link::thema1::taak4::lezen
Ik wil mijn nieuwe buren graag ontmoeten!	Я хочу познакомиться с новыми соседями!	link::thema1::taak4::lezen
