#separator:tab
#html:false
aan	на
Ik ga aan de tafel zitten.	Я сяду за стол.
Ik ga niet aan de tafel zitten.	Я не сяду за стол.
Ga je aan de tafel zitten?	Ты садишься за стол?
de aanbieding	распродажа
De aanbieding is vandaag.	Распродажа сегодня.
De aanbieding is niet vandaag.	Распродажа не сегодня.
Is de aanbieding vandaag?	Распродажа сегодня?
aantrekken	надевать
Ik trek mijn jas aan.	Я надену куртку.
Ik trek mijn jas niet aan.	Я не надену куртку.
Trek je je jas aan?	Ты надеваешь куртку?
de aardappel	картофель
Ik eet de aardappel.	Я ем картофель.
Ik eet de aardappel niet.	Я не ем картофель.
Eet je de aardappel?	Ты ешь картофель?
de aardbei	клубника
De aardbei is lekker.	Клубника вкусная.
De aardbei is niet lekker.	Клубника не вкусная.
Is de aardbei lekker?	Клубника вкусная?
afrekenen	расплачиваться
Ik reken af bij de kassa.	Я расплачиваюсь на кассе.
Ik reken niet af bij de kassa.	Я не расплачиваюсь на кассе.
Reken je af bij de kassa?	Ты расплачиваешься на кассе?
alles	всё
Ik begrijp alles.	Я понимаю всё.
Ik begrijp niet alles.	Я не понимаю всё.
Begrijp je alles?	Ты понимаешь всё?
de ananas	ананас
De ananas is zoet.	Ананас сладкий.
De ananas is niet zoet.	Ананас не сладкий.
Is de ananas zoet?	Ананас сладкий?
anderhalf	полтора
Ik koop anderhalf kilo.	Я покупаю полтора килограмма.
Ik koop niet anderhalf kilo.	Я не покупаю полтора килограмма.
Koop je anderhalf kilo?	Ты покупаешь полтора килограмма?
anders	по-другому
Ik doe het anders.	Я делаю это по-другому.
Ik doe het niet anders.	Я не делаю это по-другому.
Doe je het anders?	Ты делаешь это по-другому?
de andijvie	эндивий
De andijvie is gezond.	Эндивий полезный.
De andijvie is niet gezond.	Эндивий не полезный.
Is de andijvie gezond?	Эндивий полезный?
de appel	яблоко
Ik eet een appel.	Я ем яблоко.
Ik eet geen appel.	Я не ем яблоко.
Eet je een appel?	Ты ешь яблоко?
de armband	браслет
Ik draag een armband.	Я ношу браслет.
Ik draag geen armband.	Я не ношу браслет.
Draag je een armband?	Ты носишь браслет?
de aspirine	аспирин
Ik neem een aspirine.	Я принимаю аспирин.
Ik neem geen aspirine.	Я не принимаю аспирин.
Neem je een aspirine?	Ты принимаешь аспирин?
de bakker	пекарь
De bakker maakt brood.	Пекарь печёт хлеб.
De bakker maakt geen brood.	Пекарь не печёт хлеб.
Maakt de bakker brood?	Пекарь печёт хлеб?
de bakkerij	пекарня
De bakkerij is open.	Пекарня открыта.
De bakkerij is niet open.	Пекарня не открыта.
Is de bakkerij open?	Пекарня открыта?
de bank	банк
Ik ga naar de bank.	Я пойду в банк.
Ik ga niet naar de bank.	Я не пойду в банк.
Ga je naar de bank?	Ты идёшь в банк?
beige	бежевый
Mijn jas is beige.	Моя куртка бежевая.
Mijn jas is niet beige.	Моя куртка не бежевая.
Is jouw jas beige?	Твоя куртка бежевая?
bestellen	заказывать
Ik bestel een pizza.	Я заказываю пиццу.
Ik bestel geen pizza.	Я не заказываю пиццу.
Bestel je een pizza?	Ты заказываешь пиццу?
betalen	платить
Ik betaal contant.	Я плачу наличными.
Ik betaal niet contant.	Я не плачу наличными.
Betaal je contant?	Ты платишь наличными?
de beurt	очередь
Het is mijn beurt.	Моя очередь.
Het is niet mijn beurt.	Не моя очередь.
Is het jouw beurt?	Твоя очередь?
de bh	бюстгальтер
Ik koop een bh.	Я покупаю бюстгальтер.
Ik koop geen bh.	Я не покупаю бюстгальтер.
Koop je een bh?	Ты покупаешь бюстгальтер?
bij	у, возле
Ik werk bij de supermarkt.	Я работаю в супермаркете.
Ik werk niet bij de supermarkt.	Я не работаю в супермаркете.
Werk je bij de supermarkt?	Ты работаешь в супермаркете?
de bitterbal	биттербал
Ik eet een bitterbal.	Я ем биттербал.
Ik eet geen bitterbal.	Я не ем биттербал.
Eet je een bitterbal?	Ты ешь биттербал?
blauw	синий
Mijn trui is blauw.	Мой свитер синий.
Mijn trui is niet blauw.	Мой свитер не синий.
Is jouw trui blauw?	Твой свитер синий?
het blik	банка
Ik koop een blik soep.	Я покупаю банку супа.
Ik koop geen blik soep.	Я не покупаю банку супа.
Koop je een blik soep?	Ты покупаешь банку супа?
het blikje	баночка
Ik drink een blikje cola.	Я пью баночку колы.
Ik drink geen blikje cola.	Я не пью баночку колы.
Drink je een blikje cola?	Ты пьёшь баночку колы?
de bloem	цветок
Ik koop een bloem.	Я покупаю цветок.
Ik koop geen bloem.	Я не покупаю цветок.
Koop je een bloem?	Ты покупаешь цветок?
de bloemenzaak	цветочный магазин
De bloemenzaak is open.	Цветочный магазин открыт.
De bloemenzaak is niet open.	Цветочный магазин не открыт.
Is de bloemenzaak open?	Цветочный магазин открыт?
de bloemkool	цветная капуста
Ik koop bloemkool.	Я покупаю цветную капусту.
Ik koop geen bloemkool.	Я не покупаю цветную капусту.
Koop je bloemkool?	Ты покупаешь цветную капусту?
de blouse	блузка
Ik draag een blouse.	Я ношу блузку.
Ik draag geen blouse.	Я не ношу блузку.
Draag je een blouse?	Ты носишь блузку?
het boek	книга
Ik lees een boek.	Я читаю книгу.
Ik lees geen boek.	Я не читаю книгу.
Lees je een boek?	Ты читаешь книгу?
de boekenkast	книжный шкаф
De boekenkast is groot.	Книжный шкаф большой.
De boekenkast is niet groot.	Книжный шкаф не большой.
Is de boekenkast groot?	Книжный шкаф большой?
de boekwinkel	книжный магазин
Ik ga naar de boekwinkel.	Я пойду в книжный магазин.
Ik ga niet naar de boekwinkel.	Я не пойду в книжный магазин.
Ga je naar de boekwinkel?	Ты идёшь в книжный магазин?
het bolletje	шарик
Ik koop een bolletje ijs.	Я покупаю шарик мороженого.
Ik koop geen bolletje ijs.	Я не покупаю шарик мороженого.
Koop je een bolletje ijs?	Ты покупаешь шарик мороженого?
de boodschap	покупка
Ik doe de boodschappen.	Я делаю покупки.
Ik doe de boodschappen niet.	Я не делаю покупки.
Doe je de boodschappen?	Ты делаешь покупки?
het boontje	боб
Ik eet boontjes.	Я ем бобы.
Ik eet geen boontjes.	Я не ем бобы.
Eet je boontjes?	Ты ешь бобы?
de boormachine	дрель
Ik gebruik de boormachine.	Я использую дрель.
Ik gebruik de boormachine niet.	Я не использую дрель.
Gebruik je de boormachine?	Ты используешь дрель?
borrelhapjes	закуски
Ik eet borrelhapjes.	Я ем закуски.
Ik eet geen borrelhapjes.	Я не ем закуски.
Eet je borrelhapjes?	Ты ешь закуски?
de boter	масло
Ik koop boter.	Я покупаю масло.
Ik koop geen boter.	Я не покупаю масло.
Koop je boter?	Ты покупаешь масло?
de bouwmarkt	строймагазин
Ik ga naar de bouwmarkt.	Я пойду в строймагазин.
Ik ga niet naar de bouwmarkt.	Я не пойду в строймагазин.
Ga je naar de bouwmarkt?	Ты идёшь в строймагазин?
brengen	приносить
Ik breng een cadeau.	Я приношу подарок.
Ik breng geen cadeau.	Я не приношу подарок.
Breng je een cadeau?	Ты приносишь подарок?
de brie	бри
Ik eet brie.	Я ем бри.
Ik eet geen brie.	Я не ем бри.
Eet je brie?	Ты ешь бри?
de brief	письмо
Ik schrijf een brief.	Я пишу письмо.
Ik schrijf geen brief.	Я не пишу письмо.
Schrijf je een brief?	Ты пишешь письмо?
het briefje	бумажка
Ik geef een briefje.	Я даю бумажку.
Ik geef geen briefje.	Я не даю бумажку.
Geef je een briefje?	Ты даёшь бумажку?
de broek	брюки
Ik draag een broek.	Я ношу брюки.
Ik draag geen broek.	Я не ношу брюки.
Draag je een broek?	Ты носишь брюки?
het brood	хлеб
Ik koop brood.	Я покупаю хлеб.
Ik koop geen brood.	Я не покупаю хлеб.
Koop je brood?	Ты покупаешь хлеб?
het broodje	булочка
Ik eet een broodje.	Я ем булочку.
Ik eet geen broodje.	Я не ем булочку.
Eet je een broodje?	Ты ешь булочку?
bruin	коричневый
Mijn haar is bruin.	Мои волосы коричневые.
Mijn haar is niet bruin.	Мои волосы не коричневые.
Is jouw haar bruin?	Твои волосы коричневые?
het budget	бюджет
Het budget is klein.	Бюджет маленький.
Het budget is niet klein.	Бюджет не маленький.
Is het budget klein?	Бюджет маленький?
het bureau	стол, офис
Ik werk aan het bureau.	Я работаю за столом.
Ik werk niet aan het bureau.	Я не работаю за столом.
Werk je aan het bureau?	Ты работаешь за столом?
de bus	автобус
Ik ga met de bus.	Я поеду на автобусе.
Ik ga niet met de bus.	Я не поеду на автобусе.
Ga je met de bus?	Ты едешь на автобусе?
het busje	автобус (маленький)
Het busje komt nu.	Автобус приходит сейчас.
Het busje komt niet nu.	Автобус не приходит сейчас.
Komt het busje nu?	Автобус приходит сейчас?
het café	кафе
Ik ga naar het café.	Я пойду в кафе.
Ik ga niet naar het café.	Я не пойду в кафе.
Ga je naar het café?	Ты идёшь в кафе?
de cake	торт
Ik eet cake.	Я ем торт.
Ik eet geen cake.	Я не ем торт.
Eet je cake?	Ты ешь торт?
de cervelaat	сервелат
Ik koop cervelaat.	Я покупаю сервелат.
Ik koop geen cervelaat.	Я не покупаю сервелат.
Koop je cervelaat?	Ты покупаешь сервелат?
het colbert	пиджак
Ik draag een colbert.	Я ношу пиджак.
Ik draag geen colbert.	Я не ношу пиджак.
Draag je een colbert?	Ты носишь пиджак?
contant	наличными
Ik betaal contant.	Я плачу наличными.
Ik betaal niet contant.	Я не плачу наличными.
Betaal je contant?	Ты платишь наличными?
corrigeren	исправлять
Ik corrigeer de fout.	Я исправляю ошибку.
Ik corrigeer de fout niet.	Я не исправляю ошибку.
Corrigeer je de fout?	Ты исправляешь ошибку?
de croissant	круассан
Ik eet een croissant.	Я ем круассан.
Ik eet geen croissant.	Я не ем круассан.
Eet je een croissant?	Ты ешь круассан?
donker	тёмный
Het is donker.	Темно.
Het is niet donker.	Не темно.
Is het donker?	Темно?
donkerbruin	тёмно-коричневый
Mijn ogen zijn donkerbruin.	Мои глаза тёмно-коричневые.
Mijn ogen zijn niet donkerbruin.	Мои глаза не тёмно-коричневые.
Zijn jouw ogen donkerbruin?	Твои глаза тёмно-коричневые?
de doos	коробка
Ik pak de doos.	Я беру коробку.
Ik pak de doos niet.	Я не беру коробку.
Pak je de doos?	Ты берёшь коробку?
het doosje	коробочка
Het doosje is klein.	Коробочка маленькая.
Het doosje is niet klein.	Коробочка не маленькая.
Is het doosje klein?	Коробочка маленькая?
de dorst	жажда
Ik heb dorst.	Я хочу пить.
Ik heb geen dorst.	Я не хочу пить.
Heb je dorst?	Ты хочешь пить?
de douchecrème	крем для душа
Ik gebruik douchecrème.	Я использую крем для душа.
Ik gebruik geen douchecrème.	Я не использую крем для душа.
Gebruik je douchecrème?	Ты используешь крем для душа?
dragen	носить
Ik draag een tas.	Я ношу сумку.
Ik draag geen tas.	Я не ношу сумку.
Draag je een tas?	Ты носишь сумку?
het dressoir	сервант
Het dressoir staat in de woonkamer.	Сервант стоит в гостиной.
Het dressoir staat niet in de woonkamer.	Сервант не стоит в гостиной.
Staat het dressoir in de woonkamer?	Сервант стоит в гостиной?
drinken	пить
Ik drink water.	Я пью воду.
Ik drink geen water.	Я не пью воду.
Drink je water?	Ты пьёшь воду?
de drogist	аптекарь
De drogist helpt mij.	Аптекарь помогает мне.
De drogist helpt mij niet.	Аптекарь не помогает мне.
Helpt de drogist jou?	Аптекарь помогает тебе?
de drogisterij	аптека
Ik ga naar de drogisterij.	Я пойду в аптеку.
Ik ga niet naar de drogisterij.	Я не пойду в аптеку.
Ga je naar de drogisterij?	Ты идёшь в аптеку?
de druif	виноград
Ik eet druiven.	Я ем виноград.
Ik eet geen druiven.	Я не ем виноград.
Eet je druiven?	Ты ешь виноград?
duur	дорогой
Het is duur.	Это дорого.
Het is niet duur.	Это не дорого.
Is het duur?	Это дорого?
eens	однажды, когда-нибудь, даже
Ik ga eens naar de stad.	Я пойду когда-нибудь в город.
Ik ga niet eens naar de stad.	Я даже не пойду в город.
Ga je eens naar de stad?	Ты пойдёшь когда-нибудь в город?
de eettafel	обеденный стол
De eettafel is groot.	Обеденный стол большой.
De eettafel is niet groot.	Обеденный стол не большой.
Is de eettafel groot?	Обеденный стол большой?
elkaar	друг друга
We helpen elkaar.	Мы помогаем друг другу.
We helpen elkaar niet.	Мы не помогаем друг другу.
Helpen jullie elkaar?	Вы помогаете друг другу?
er	там, туда
Ik ga erheen.	Я пойду туда.
Ik ga er niet heen.	Я не пойду туда.
Ga je erheen?	Ты идёшь туда?
eten	есть
Ik eet brood.	Я ем хлеб.
Ik eet geen brood.	Я не ем хлеб.
Eet je brood?	Ты ешь хлеб?
de fauteuil	кресло
Ik zit in de fauteuil.	Я сижу в кресле.
Ik zit niet in de fauteuil.	Я не сижу в кресле.
Zit je in de fauteuil?	Ты сидишь в кресле?
fijn	хороший
Dat is fijn.	Это хорошо.
Dat is niet fijn.	Это не хорошо.
Is dat fijn?	Это хорошо?
de flat	квартира
Ik woon in een flat.	Я живу в квартире.
Ik woon niet in een flat.	Я не живу в квартире.
Woon je in een flat?	Ты живёшь в квартире?
de fles	бутылка
Ik koop een fles wijn.	Я покупаю бутылку вина.
Ik koop geen fles wijn.	Я не покупаю бутылку вина.
Koop je een fles wijn?	Ты покупаешь бутылку вина?
het flesje	бутылочка
Het flesje is leeg.	Бутылочка пустая.
Het flesje is niet leeg.	Бутылочка не пустая.
Is het flesje leeg?	Бутылочка пустая?
de framboos	малина
Ik eet frambozen.	Я ем малину.
Ik eet geen frambozen.	Я не ем малину.
Eet je frambozen?	Ты ешь малину?
het gebak	выпечка
Ik koop gebak.	Я покупаю выпечку.
Ik koop geen gebak.	Я не покупаю выпечку.
Koop je gebak?	Ты покупаешь выпечку?
geel	жёлтый
De zon is geel.	Солнце жёлтое.
De zon is niet geel.	Солнце не жёлтое.
Is de zon geel?	Солнце жёлтое?
het gehakt	фарш
Ik koop gehakt.	Я покупаю фарш.
Ik koop geen gehakt.	Я не покупаю фарш.
Koop je gehakt?	Ты покупаешь фарш?
gesneden	нарезанный
Het brood is gesneden.	Хлеб нарезанный.
Het brood is niet gesneden.	Хлеб не нарезанный.
Is het brood gesneden?	Хлеб нарезанный?
gezond	здоровый
Groente is gezond.	Овощи полезные.
Groente is niet gezond.	Овощи не полезные.
Is groente gezond?	Овощи полезные?
goedkoop	дешёвый
Het is goedkoop.	Это дёшево.
Het is niet goedkoop.	Это не дёшево.
Is het goedkoop?	Это дёшево?
het gram	грамм
Ik koop vijfhonderd gram.	Я покупаю пятьсот грамм.
Ik koop niet vijfhonderd gram.	Я не покупаю пятьсот грамм.
Koop je vijfhonderd gram?	Ты покупаешь пятьсот грамм?
grijs	серый
Mijn trui is grijs.	Мой свитер серый.
Mijn trui is niet grijs.	Мой свитер не серый.
Is jouw trui grijs?	Твой свитер серый?
groen	зелёный
Het gras is groen.	Трава зелёная.
Het gras is niet groen.	Трава не зелёная.
Is het gras groen?	Трава зелёная?
de groente	овощ
Ik eet groente.	Я ем овощи.
Ik eet geen groente.	Я не ем овощи.
Eet je groente?	Ты ешь овощи?
de groenteman	овощник
De groenteman verkoopt groente.	Овощник продаёт овощи.
De groenteman verkoopt geen groente.	Овощник не продаёт овощи.
Verkoopt de groenteman groente?	Овощник продаёт овощи?
de hak	каблук
De hak is hoog.	Каблук высокий.
De hak is niet hoog.	Каблук не высокий.
Is de hak hoog?	Каблук высокий?
half	половина
Het is half negen.	Половина девятого.
Het is niet half negen.	Не половина девятого.
Is het half negen?	Половина девятого?
de halsketting	ожерелье
Ik draag een halsketting.	Я ношу ожерелье.
Ik draag geen halsketting.	Я не ношу ожерелье.
Draag je een halsketting?	Ты носишь ожерелье?
de ham	ветчина
Ik eet ham.	Я ем ветчину.
Ik eet geen ham.	Я не ем ветчину.
Eet je ham?	Ты ешь ветчину?
de hamburger	гамбургер
Ik eet een hamburger.	Я ем гамбургер.
Ik eet geen hamburger.	Я не ем гамбургер.
Eet je een hamburger?	Ты ешь гамбургер?
de hamer	молоток
Ik gebruik de hamer.	Я использую молоток.
Ik gebruik de hamer niet.	Я не использую молоток.
Gebruik je de hamer?	Ты используешь молоток?
de handdoek	полотенце
Ik gebruik een handdoek.	Я использую полотенце.
Ik gebruik geen handdoek.	Я не использую полотенце.
Gebruik je een handdoek?	Ты используешь полотенце?
de handschoen	перчатка
Ik draag handschoenen.	Я ношу перчатки.
Ik draag geen handschoenen.	Я не ношу перчатки.
Draag je handschoenen?	Ты носишь перчатки?
hangen	висеть
De jas hangt aan de kapstok.	Куртка висит на вешалке.
De jas hangt niet aan de kapstok.	Куртка не висит на вешалке.
Hangt de jas aan de kapstok?	Куртка висит на вешалке?
hartstikke	очень
Het is hartstikke leuk.	Это очень весело.
Het is niet hartstikke leuk.	Это не очень весело.
Is het hartstikke leuk?	Это очень весело?
heerlijk	вкусный
Het eten is heerlijk.	Еда вкусная.
Het eten is niet heerlijk.	Еда не вкусная.
Is het eten heerlijk?	Еда вкусная?
heet	горячий
De koffie is heet.	Кофе горячий.
De koffie is niet heet.	Кофе не горячий.
Is de koffie heet?	Кофе горячий?
helaas	к сожалению
Helaas kan ik niet komen.	К сожалению, я не могу прийти.
Helaas kan ik wel komen.	К сожалению, я могу прийти.
Kan je helaas niet komen?	К сожалению, ты не можешь прийти?
helpen	помогать
Ik help jou.	Я помогаю тебе.
Ik help jou niet.	Я не помогаю тебе.
Help je mij?	Ты помогаешь мне?
hem	его
Ik zie hem.	Я вижу его.
Ik zie hem niet.	Я не вижу его.
Zie je hem?	Ты видишь его?
hen	их
Ik zie hen.	Я вижу их.
Ik zie hen niet.	Я не вижу их.
Zie je hen?	Ты видишь их?
honger	голод
Ik heb honger.	Я хочу есть.
Ik heb geen honger.	Я не хочу есть.
Heb je honger?	Ты хочешь есть?
hoog	высокий
De tafel is hoog.	Стол высокий.
De tafel is niet hoog.	Стол не высокий.
Is de tafel hoog?	Стол высокий?
hun	их
Ik zie hun huis.	Я вижу их дом.
Ik zie hun huis niet.	Я не вижу их дом.
Zie je hun huis?	Ты видишь их дом?
inderdaad	действительно
Inderdaad, dat klopt.	Действительно, это правильно.
Inderdaad, dat klopt niet.	Действительно, это не правильно.
Klopt dat inderdaad?	Это действительно правильно?
interessant	интересный
Het is interessant.	Это интересно.
Het is niet interessant.	Это не интересно.
Is het interessant?	Это интересно?
jammer	жаль
Jammer dat je niet komt.	Жаль, что ты не приходишь.
Het is niet jammer.	Не жаль.
Is het jammer?	Жаль?
de jas	куртка
Ik draag een jas.	Я ношу куртку.
Ik draag geen jas.	Я не ношу куртку.
Draag je een jas?	Ты носишь куртку?
de jenever	джин
Ik drink jenever.	Я пью джин.
Ik drink geen jenever.	Я не пью джин.
Drink je jenever?	Ты пьёшь джин?
jong	молодой
Hij is jong.	Он молодой.
Hij is niet jong.	Он не молодой.
Is hij jong?	Он молодой?
jou	тебя
Ik zie jou.	Я вижу тебя.
Ik zie jou niet.	Я не вижу тебя.
Zie je mij?	Ты видишь меня?
de jurk	платье
Ik draag een jurk.	Я ношу платье.
Ik draag geen jurk.	Я не ношу платье.
Draag je een jurk?	Ты носишь платье?
de juwelier	ювелир
Ik ga naar de juwelier.	Я пойду к ювелиру.
Ik ga niet naar de juwelier.	Я не пойду к ювелиру.
Ga je naar de juwelier?	Ты идёшь к ювелиру?
de kaas	сыр
Ik eet kaas.	Я ем сыр.
Ik eet geen kaas.	Я не ем сыр.
Eet je kaas?	Ты ешь сыр?
de kalender	календарь
Ik kijk naar de kalender.	Я смотрю на календарь.
Ik kijk niet naar de kalender.	Я не смотрю на календарь.
Kijk je naar de kalender?	Ты смотришь на календарь?
de keeltablet	таблетка от горла
Ik neem een keeltablet.	Я принимаю таблетку от горла.
Ik neem geen keeltablet.	Я не принимаю таблетку от горла.
Neem je een keeltablet?	Ты принимаешь таблетку от горла?
de kers	вишня
Ik eet kersen.	Я ем вишню.
Ik eet geen kersen.	Я не ем вишню.
Eet je kersen?	Ты ешь вишню?
de ketchup	кетчуп
Ik gebruik ketchup.	Я использую кетчуп.
Ik gebruik geen ketchup.	Я не использую кетчуп.
Gebruik je ketchup?	Ты используешь кетчуп?
de keus	выбор
Ik heb keus.	У меня есть выбор.
Ik heb geen keus.	У меня нет выбора.
Heb je keus?	У тебя есть выбор?
kijken	смотреть
Ik kijk naar de tv.	Я смотрю телевизор.
Ik kijk niet naar de tv.	Я не смотрю телевизор.
Kijk je naar de tv?	Ты смотришь телевизор?
de kilo	килограмм
Ik koop een kilo.	Я покупаю килограмм.
Ik koop geen kilo.	Я не покупаю килограмм.
Koop je een kilo?	Ты покупаешь килограмм?
de kip	курица
Ik eet kip.	Я ем курицу.
Ik eet geen kip.	Я не ем курицу.
Eet je kip?	Ты ешь курицу?
de kipfilet	куриное филе
Ik koop kipfilet.	Я покупаю куриное филе.
Ik koop geen kipfilet.	Я не покупаю куриное филе.
Koop je kipfilet?	Ты покупаешь куриное филе?
de kippenbout	куриная ножка
Ik eet een kippenbout.	Я ем куриную ножку.
Ik eet geen kippenbout.	Я не ем куриную ножку.
Eet je een kippenbout?	Ты ешь куриную ножку?
de kippenpoot	куриная лапка
Ik eet een kippenpoot.	Я ем куриную лапку.
Ik eet geen kippenpoot.	Я не ем куриную лапку.
Eet je een kippenpoot?	Ты ешь куриную лапку?
de klant	клиент
Ik ben een klant.	Я клиент.
Ik ben geen klant.	Я не клиент.
Ben je een klant?	Ты клиент?
de kleding	одежда
Ik koop kleding.	Я покупаю одежду.
Ik koop geen kleding.	Я не покупаю одежду.
Koop je kleding?	Ты покупаешь одежду?
de kledingwinkel	магазин одежды
Ik ga naar de kledingwinkel.	Я пойду в магазин одежды.
Ik ga niet naar de kledingwinkel.	Я не пойду в магазин одежды.
Ga je naar de kledingwinkel?	Ты идёшь в магазин одежды?
klein	маленький
Het huis is klein.	Дом маленький.
Het huis is niet klein.	Дом не маленький.
Is het huis klein?	Дом маленький?
de kleren	одежда
Ik draag kleren.	Я ношу одежду.
Ik draag geen kleren.	Я не ношу одежду.
Draag je kleren?	Ты носишь одежду?
de kleur	цвет
Ik hou van deze kleur.	Я люблю этот цвет.
Ik hou niet van deze kleur.	Я не люблю этот цвет.
Hou je van deze kleur?	Ты любишь этот цвет?
het koekje	печенье
Ik eet een koekje.	Я ем печенье.
Ik eet geen koekje.	Я не ем печенье.
Eet je een koekje?	Ты ешь печенье?
koel	прохладный
Het is koel.	Прохладно.
Het is niet koel.	Не прохладно.
Is het koel?	Прохладно?
de komkommer	огурец
Ik eet komkommer.	Я ем огурец.
Ik eet geen komkommer.	Я не ем огурец.
Eet je komkommer?	Ты ешь огурец?
koken	готовить
Ik kook avondeten.	Я готовлю ужин.
Ik kook geen avondeten.	Я не готовлю ужин.
Kook je avondeten?	Ты готовишь ужин?
de koopavond	вечер покупок
Ik ga op koopavond.	Я пойду на вечер покупок.
Ik ga niet op koopavond.	Я не пойду на вечер покупок.
Ga je op koopavond?	Ты идёшь на вечер покупок?
kort	короткий
Mijn haar is kort.	Мои волосы короткие.
Mijn haar is niet kort.	Мои волосы не короткие.
Is jouw haar kort?	Твои волосы короткие?
kosten	стоить
Het kost tien euro.	Это стоит десять евро.
Het kost niet tien euro.	Это не стоит десять евро.
Kost het tien euro?	Это стоит десять евро?
het kostuum	костюм
Ik draag een kostuum.	Я ношу костюм.
Ik draag geen kostuum.	Я не ношу костюм.
Draag je een kostuum?	Ты носишь костюм?
koud	холодный
Het is koud.	Холодно.
Het is niet koud.	Не холодно.
Is het koud?	Холодно?
de krant	газета
Ik lees de krant.	Я читаю газету.
Ik lees de krant niet.	Я не читаю газету.
Lees je de krant?	Ты читаешь газету?
de krentenbol	булочка с изюмом
Ik eet een krentenbol.	Я ем булочку с изюмом.
Ik eet geen krentenbol.	Я не ем булочку с изюмом.
Eet je een krentenbol?	Ты ешь булочку с изюмом?
de krop	кочан
Ik koop een krop sla.	Я покупаю кочан салата.
Ik koop geen krop sla.	Я не покупаю кочан салата.
Koop je een krop sla?	Ты покупаешь кочан салата?
de kruk	табуретка
Ik zit op een kruk.	Я сижу на табуретке.
Ik zit niet op een kruk.	Я не сижу на табуретке.
Zit je op een kruk?	Ты сидишь на табуретке?
laag	низкий
De tafel is laag.	Стол низкий.
De tafel is niet laag.	Стол не низкий.
Is de tafel laag?	Стол низкий?
de laars	сапог
Ik draag laarzen.	Я ношу сапоги.
Ik draag geen laarzen.	Я не ношу сапоги.
Draag je laarzen?	Ты носишь сапоги?
het lamsvlees	баранина
Ik eet lamsvlees.	Я ем баранину.
Ik eet geen lamsvlees.	Я не ем баранину.
Eet je lamsvlees?	Ты ешь баранину?
lang	длинный
Mijn haar is lang.	Мои волосы длинные.
Mijn haar is niet lang.	Мои волосы не длинные.
Is jouw haar lang?	Твои волосы длинные?
lelijk	некрасивый
Het is lelijk.	Это некрасиво.
Het is niet lelijk.	Это не некрасиво.
Is het lelijk?	Это некрасиво?
lekker	вкусный
Het eten is lekker.	Еда вкусная.
Het eten is niet lekker.	Еда не вкусная.
Is het eten lekker?	Еда вкусная?
licht	светлый
Het is licht.	Светло.
Het is niet licht.	Не светло.
Is het licht?	Светло?
lichtbruin	светло-коричневый
Mijn haar is lichtbruin.	Мои волосы светло-коричневые.
Mijn haar is niet lichtbruin.	Мои волосы не светло-коричневые.
Is jouw haar lichtbruin?	Твои волосы светло-коричневые?
lijken	похоже
Het lijkt goed.	Это похоже на хорошее.
Het lijkt niet goed.	Это не похоже на хорошее.
Lijkt het goed?	Это похоже на хорошее?
de lippenstift	помада
Ik gebruik lippenstift.	Я использую помаду.
Ik gebruik geen lippenstift.	Я не использую помаду.
Gebruik je lippenstift?	Ты используешь помаду?
lopen	ходить
Ik loop naar de winkel.	Я пойду в магазин.
Ik loop niet naar de winkel.	Я не пойду в магазин.
Loop je naar de winkel?	Ты идёшь в магазин?
maar	но
Ik wil komen, maar ik kan niet.	Я хочу прийти, но не могу.
Ik wil niet komen, maar ik kan wel.	Я не хочу прийти, но могу.
Wil je komen, maar kan je niet?	Ты хочешь прийти, но не можешь?
de maat	размер
Ik heb maat 42.	У меня размер 42.
Ik heb geen maat 42.	У меня не размер 42.
Heb je maat 42?	У тебя размер 42?
de make-up	макияж
Ik draag make-up.	Я ношу макияж.
Ik draag geen make-up.	Я не ношу макияж.
Draag je make-up?	Ты носишь макияж?
de mandarijn	мандарин
Ik eet een mandarijn.	Я ем мандарин.
Ik eet geen mandarijn.	Я не ем мандарин.
Eet je een mandarijn?	Ты ешь мандарин?
de marktkraam	рыночный лоток
Ik koop bij de marktkraam.	Я покупаю у рыночного лотка.
Ik koop niet bij de marktkraam.	Я не покупаю у рыночного лотка.
Koop je bij de marktkraam?	Ты покупаешь у рыночного лотка?
de melk	молоко
Ik drink melk.	Я пью молоко.
Ik drink geen melk.	Я не пью молоко.
Drink je melk?	Ты пьёшь молоко?
de meloen	дыня
Ik eet meloen.	Я ем дыню.
Ik eet geen meloen.	Я не ем дыню.
Eet je meloen?	Ты ешь дыню?
de meneer	господин
Meneer Jansen is vriendelijk.	Господин Янсен дружелюбный.
Meneer Jansen is niet vriendelijk.	Господин Янсен не дружелюбный.
Is meneer Jansen vriendelijk?	Господин Янсен дружелюбный?
het menu	меню
Ik kijk naar het menu.	Я смотрю в меню.
Ik kijk niet naar het menu.	Я не смотрю в меню.
Kijk je naar het menu?	Ты смотришь в меню?
met	с
Ik ga met jou.	Я пойду с тобой.
Ik ga niet met jou.	Я не пойду с тобой.
Ga je met mij?	Ты идёшь со мной?
mild	мягкий
Het is mild.	Это мягко.
Het is niet mild.	Это не мягко.
Is het mild?	Это мягко?
misschien	может быть
Misschien kom ik morgen.	Может быть, я приду завтра.
Misschien kom ik niet morgen.	Может быть, я не приду завтра.
Kom je misschien morgen?	Ты можешь прийти завтра?
het model	модель
Ik koop dit model.	Я покупаю эту модель.
Ik koop dit model niet.	Я не покупаю эту модель.
Koop je dit model?	Ты покупаешь эту модель?
mooi	красивый
Het is mooi.	Это красиво.
Het is niet mooi.	Это не красиво.
Is het mooi?	Это красиво?
de mouw	рукав
De mouw is lang.	Рукав длинный.
De mouw is niet lang.	Рукав не длинный.
Is de mouw lang?	Рукав длинный?
natuurlijk	конечно
Natuurlijk help ik je.	Конечно, я помогу тебе.
Natuurlijk help ik je niet.	Конечно, я не помогу тебе.
Help je me natuurlijk?	Ты, конечно, поможешь мне?
nemen	брать
Ik neem een appel.	Я беру яблоко.
Ik neem geen appel.	Я не беру яблоко.
Neem je een appel?	Ты берёшь яблоко?
nog	ещё
Ik heb nog tijd.	У меня ещё есть время.
Ik heb geen tijd meer.	У меня больше нет времени.
Heb je nog tijd?	У тебя ещё есть время?
de ober	официант
De ober brengt het eten.	Официант приносит еду.
De ober brengt het eten niet.	Официант не приносит еду.
Brengt de ober het eten?	Официант приносит еду?
het ogenblik	момент
Wacht even een ogenblik.	Подожди минутку.
Wacht niet even een ogenblik.	Не жди минутку.
Wacht je even een ogenblik?	Ты подождёшь минутку?
oké	хорошо
Oké, ik kom.	Хорошо, я приду.
Oké, ik kom niet.	Хорошо, я не приду.
Kom je oké?	Ты придёшь, хорошо?
de olie	масло
Ik gebruik olie.	Я использую масло.
Ik gebruik geen olie.	Я не использую масло.
Gebruik je olie?	Ты используешь масло?
de onderbroek	трусы
Ik draag een onderbroek.	Я ношу трусы.
Ik draag geen onderbroek.	Я не ношу трусы.
Draag je een onderbroek?	Ты носишь трусы?
het ondergoed	нижнее бельё
Ik koop ondergoed.	Я покупаю нижнее бельё.
Ik koop geen ondergoed.	Я не покупаю нижнее бельё.
Koop je ondergoed?	Ты покупаешь нижнее бельё?
ongeveer	примерно
Het is ongeveer tien uur.	Примерно десять часов.
Het is niet ongeveer tien uur.	Не примерно десять часов.
Is het ongeveer tien uur?	Примерно десять часов?
ongezond	нездоровый
Fastfood is ongezond.	Фастфуд нездоровый.
Fastfood is niet ongezond.	Фастфуд не нездоровый.
Is fastfood ongezond?	Фастфуд нездоровый?
ons	наш
Dit is ons huis.	Это наш дом.
Dit is niet ons huis.	Это не наш дом.
Is dit ons huis?	Это наш дом?
ook	тоже
Ik kom ook.	Я тоже приду.
Ik kom niet ook.	Я не приду тоже.
Kom je ook?	Ты тоже придёшь?
de oorbel	серёжка
Ik draag oorbellen.	Я ношу серёжки.
Ik draag geen oorbellen.	Я не ношу серёжки.
Draag je oorbellen?	Ты носишь серёжки?
oranje	оранжевый
De sinaasappel is oranje.	Апельсин оранжевый.
De sinaasappel is niet oranje.	Апельсин не оранжевый.
Is de sinaasappel oranje?	Апельсин оранжевый?
het overhemd	рубашка
Ik draag een overhemd.	Я ношу рубашку.
Ik draag geen overhemd.	Я не ношу рубашку.
Draag je een overhemd?	Ты носишь рубашку?
de overkant	другая сторона
Ik woon aan de overkant.	Я живу на другой стороне.
Ik woon niet aan de overkant.	Я не живу на другой стороне.
Woon je aan de overkant?	Ты живёшь на другой стороне?
het paar	пара
Ik koop een paar schoenen.	Я покупаю пару туфель.
Ik koop geen paar schoenen.	Я не покупаю пару туфель.
Koop je een paar schoenen?	Ты покупаешь пару туфель?
paars	фиолетовый
Mijn trui is paars.	Мой свитер фиолетовый.
Mijn trui is niet paars.	Мой свитер не фиолетовый.
Is jouw trui paars?	Твой свитер фиолетовый?
het pak	пакет
Ik koop een pak melk.	Я покупаю пакет молока.
Ik koop geen pak melk.	Я не покупаю пакет молока.
Koop je een pak melk?	Ты покупаешь пакет молока?
het pakje	посылка
Ik ontvang een pakje.	Я получаю посылку.
Ik ontvang geen pakje.	Я не получаю посылку.
Ontvang je een pakje?	Ты получаешь посылку?
de pantoffel	тапочка
Ik draag pantoffels.	Я ношу тапочки.
Ik draag geen pantoffels.	Я не ношу тапочки.
Draag je pantoffels?	Ты носишь тапочки?
het papier	бумага
Ik gebruik papier.	Я использую бумагу.
Ik gebruik geen papier.	Я не использую бумагу.
Gebruik je papier?	Ты используешь бумагу?
de paprika	перец
Ik eet paprika.	Я ем перец.
Ik eet geen paprika.	Я не ем перец.
Eet je paprika?	Ты ешь перец?
passen	подходить
De schoenen passen.	Туфли подходят.
De schoenen passen niet.	Туфли не подходят.
Passen de schoenen?	Туфли подходят?
de paté	паштет
Ik eet paté.	Я ем паштет.
Ik eet geen paté.	Я не ем паштет.
Eet je paté?	Ты ешь паштет?
de peer	груша
Ik eet een peer.	Я ем грушу.
Ik eet geen peer.	Я не ем грушу.
Eet je een peer?	Ты ешь грушу?
het pilsje	пиво
Ik drink een pilsje.	Я пью пиво.
Ik drink geen pilsje.	Я не пью пиво.
Drink je een pilsje?	Ты пьёшь пиво?
de pinautomaat	банкомат
Ik gebruik de pinautomaat.	Я использую банкомат.
Ik gebruik de pinautomaat niet.	Я не использую банкомат.
Gebruik je de pinautomaat?	Ты используешь банкомат?
pinnen	платить картой
Ik pin bij de kassa.	Я плачу картой на кассе.
Ik pin niet bij de kassa.	Я не плачу картой на кассе.
Pin je bij de kassa?	Ты платишь картой на кассе?
de pinpas	банковская карта
Ik gebruik mijn pinpas.	Я использую свою банковскую карту.
Ik gebruik mijn pinpas niet.	Я не использую свою банковскую карту.
Gebruik je jouw pinpas?	Ты используешь свою банковскую карту?
pittig	острый
Het eten is pittig.	Еда острая.
Het eten is niet pittig.	Еда не острая.
Is het eten pittig?	Еда острая?
de pizza	пицца
Ik eet pizza.	Я ем пиццу.
Ik eet geen pizza.	Я не ем пиццу.
Eet je pizza?	Ты ешь пиццу?
de plant	растение
Ik geef water aan de plant.	Я поливаю растение.
Ik geef geen water aan de plant.	Я не поливаю растение.
Geef je water aan de plant?	Ты поливаешь растение?
de pleister	пластырь
Ik gebruik een pleister.	Я использую пластырь.
Ik gebruik geen pleister.	Я не использую пластырь.
Gebruik je een pleister?	Ты используешь пластырь?
het poloshirt	поло
Ik draag een poloshirt.	Я ношу поло.
Ik draag geen poloshirt.	Я не ношу поло.
Draag je een poloshirt?	Ты носишь поло?
het pond	фунт
Ik koop een pond.	Я покупаю фунт.
Ik koop geen pond.	Я не покупаю фунт.
Koop je een pond?	Ты покупаешь фунт?
de port	портвейн
Ik drink port.	Я пью портвейн.
Ik drink geen port.	Я не пью портвейн.
Drink je port?	Ты пьёшь портвейн?
de portie	порция
Ik neem een portie.	Я беру порцию.
Ik neem geen portie.	Я не беру порцию.
Neem je een portie?	Ты берёшь порцию?
het postuur	телосложение
Ik heb een goed postuur.	У меня хорошее телосложение.
Ik heb geen goed postuur.	У меня не хорошее телосложение.
Heb je een goed postuur?	У тебя хорошее телосложение?
de prei	лук-порей
Ik koop prei.	Я покупаю лук-порей.
Ik koop geen prei.	Я не покупаю лук-порей.
Koop je prei?	Ты покупаешь лук-порей?
prettig	приятный
Het is prettig.	Это приятно.
Het is niet prettig.	Это не приятно.
Is het prettig?	Это приятно?
de prijs	цена
De prijs is hoog.	Цена высокая.
De prijs is niet hoog.	Цена не высокая.
Is de prijs hoog?	Цена высокая?
prima	отлично
Dat is prima.	Это отлично.
Dat is niet prima.	Это не отлично.
Is dat prima?	Это отлично?
de printer	принтер
Ik gebruik de printer.	Я использую принтер.
Ik gebruik de printer niet.	Я не использую принтер.
Gebruik je de printer?	Ты используешь принтер?
proberen	пробовать
Ik probeer het.	Я пробую это.
Ik probeer het niet.	Я не пробую это.
Probeer je het?	Ты пробуешь это?
het probleem	проблема
Ik heb een probleem.	У меня проблема.
Ik heb geen probleem.	У меня нет проблемы.
Heb je een probleem?	У тебя проблема?
het product	продукт
Ik koop dit product.	Я покупаю этот продукт.
Ik koop dit product niet.	Я не покупаю этот продукт.
Koop je dit product?	Ты покупаешь этот продукт?
de pyjama	пижама
Ik draag een pyjama.	Я ношу пижаму.
Ik draag geen pyjama.	Я не ношу пижаму.
Draag je een pyjama?	Ты носишь пижаму?
de reep	плитка
Ik eet een reep chocola.	Я ем плитку шоколада.
Ik eet geen reep chocola.	Я не ем плитку шоколада.
Eet je een reep chocola?	Ты ешь плитку шоколада?
de rekening	счёт
Ik betaal de rekening.	Я плачу по счету.
Ik betaal de rekening niet.	Я не плачу по счету.
Betaal je de rekening?	Ты платишь по счету?
rijp	спелый
De appel is rijp.	Яблоко спелое.
De appel is niet rijp.	Яблоко не спелое.
Is de appel rijp?	Яблоко спелое?
de ring	кольцо
Ik draag een ring.	Я ношу кольцо.
Ik draag geen ring.	Я не ношу кольцо.
Draag je een ring?	Ты носишь кольцо?
de rok	юбка
Ik draag een rok.	Я ношу юбку.
Ik draag geen rok.	Я не ношу юбку.
Draag je een rok?	Ты носишь юбку?
de rol	рулон
Ik koop een rol wc-papier.	Я покупаю рулон туалетной бумаги.
Ik koop geen rol wc-papier.	Я не покупаю рулон туалетной бумаги.
Koop je een rol wc-papier?	Ты покупаешь рулон туалетной бумаги?
de rollade	рулет
Ik koop rollade.	Я покупаю рулет.
Ik koop geen rollade.	Я не покупаю рулет.
Koop je rollade?	Ты покупаешь рулет?
het rolletje	рулончик
Het rolletje is leeg.	Рулончик пустой.
Het rolletje is niet leeg.	Рулончик не пустой.
Is het rolletje leeg?	Рулончик пустой?
rood	красный
De appel is rood.	Яблоко красное.
De appel is niet rood.	Яблоко не красное.
Is de appel rood?	Яблоко красное?
de roos	роза
Ik koop een roos.	Я покупаю розу.
Ik koop geen roos.	Я не покупаю розу.
Koop je een roos?	Ты покупаешь розу?
de rosé	розовое вино
Ik drink rosé.	Я пью розовое вино.
Ik drink geen rosé.	Я не пью розовое вино.
Drink je rosé?	Ты пьёшь розовое вино?
roze	розовый
Mijn trui is roze.	Мой свитер розовый.
Mijn trui is niet roze.	Мой свитер не розовый.
Is jouw trui roze?	Твой свитер розовый?
het rundvlees	говядина
Ik eet rundvlees.	Я ем говядину.
Ik eet geen rundvlees.	Я не ем говядину.
Eet je rundvlees?	Ты ешь говядину?
de salami	салями
Ik eet salami.	Я ем салями.
Ik eet geen salami.	Я не ем салями.
Eet je salami?	Ты ешь салями?
samen	вместе
We gaan samen.	Мы пойдём вместе.
We gaan niet samen.	Мы не пойдём вместе.
Gaan jullie samen?	Вы идёте вместе?
de sandaal	сандалия
Ik draag sandalen.	Я ношу сандалии.
Ik draag geen sandalen.	Я не ношу сандалии.
Draag je sandalen?	Ты носишь сандалии?
sappig	сочный
De appel is sappig.	Яблоко сочное.
De appel is niet sappig.	Яблоко не сочное.
Is de appel sappig?	Яблоко сочное?
de schoen	туфля
Ik draag schoenen.	Я ношу туфли.
Ik draag geen schoenen.	Я не ношу туфли.
Draag je schoenen?	Ты носишь туфли?
de schoenenzaak	обувной магазин
Ik ga naar de schoenenzaak.	Я пойду в обувной магазин.
Ik ga niet naar de schoenenzaak.	Я не пойду в обувной магазин.
Ga je naar de schoenenzaak?	Ты идёшь в обувной магазин?
het servies	сервиз
Ik koop servies.	Я покупаю сервиз.
Ik koop geen servies.	Я не покупаю сервиз.
Koop je servies?	Ты покупаешь сервиз?
de shampoo	шампунь
Ik gebruik shampoo.	Я использую шампунь.
Ik gebruik geen shampoo.	Я не использую шампунь.
Gebruik je shampoo?	Ты используешь шампунь?
het shirt	рубашка
Ik draag een shirt.	Я ношу рубашку.
Ik draag geen shirt.	Я не ношу рубашку.
Draag je een shirt?	Ты носишь рубашку?
de sinaasappel	апельсин
Ik eet een sinaasappel.	Я ем апельсин.
Ik eet geen sinaasappel.	Я не ем апельсин.
Eet je een sinaasappel?	Ты ешь апельсин?
de sjaal	шарф
Ik draag een sjaal.	Я ношу шарф.
Ik draag geen sjaal.	Я не ношу шарф.
Draag je een sjaal?	Ты носишь шарф?
de sla	салат
Ik eet sla.	Я ем салат.
Ik eet geen sla.	Я не ем салат.
Eet je sla?	Ты ешь салат?
de slager	мясник
De slager verkoopt vlees.	Мясник продаёт мясо.
De slager verkoopt geen vlees.	Мясник не продаёт мясо.
Verkoopt de slager vlees?	Мясник продаёт мясо?
de slagerij	мясная лавка
Ik ga naar de slagerij.	Я пойду в мясную лавку.
Ik ga niet naar de slagerij.	Я не пойду в мясную лавку.
Ga je naar de slagerij?	Ты идёшь в мясную лавку?
de slagroom	сливки
Ik gebruik slagroom.	Я использую сливки.
Ik gebruik geen slagroom.	Я не использую сливки.
Gebruik je slagroom?	Ты используешь сливки?
het slipje	трусики
Ik draag een slipje.	Я ношу трусики.
Ik draag geen slipje.	Я не ношу трусики.
Draag je een slipje?	Ты носишь трусики?
de slipper	шлёпанцы
Ik draag slippers.	Я ношу шлёпанцы.
Ik draag geen slippers.	Я не ношу шлёпанцы.
Draag je slippers?	Ты носишь шлёпанцы?
smaken	вкус
Het smaakt goed.	Это вкусно.
Het smaakt niet goed.	Это не вкусно.
Smaakt het goed?	Это вкусно?
de snijboon	стручковая фасоль
Ik eet snijbonen.	Я ем стручковую фасоль.
Ik eet geen snijbonen.	Я не ем стручковую фасоль.
Eet je snijbonen?	Ты ешь стручковую фасоль?
de sok	носок
Ik draag sokken.	Я ношу носки.
Ik draag geen sokken.	Я не ношу носки.
Draag je sokken?	Ты носишь носки?
sorry	извините
Sorry, ik ben te laat.	Извините, я опаздываю.
Sorry, ik ben niet te laat.	Извините, я не опаздываю.
Ben je sorry?	Ты извиняешься?
de spaghetti	спагетти
Ik eet spaghetti.	Я ем спагетти.
Ik eet geen spaghetti.	Я не ем спагетти.
Eet je spaghetti?	Ты ешь спагетти?
speciaal	особенный
Het is speciaal.	Это особенное.
Het is niet speciaal.	Это не особенное.
Is het speciaal?	Это особенное?
de spijkerbroek	джинсы
Ik draag een spijkerbroek.	Я ношу джинсы.
Ik draag geen spijkerbroek.	Я не ношу джинсы.
Draag je een spijkerbroek?	Ты носишь джинсы?
de spinazie	шпинат
Ik eet spinazie.	Я ем шпинат.
Ik eet geen spinazie.	Я не ем шпинат.
Eet je spinazie?	Ты ешь шпинат?
de stem	голос
Ik hoor jouw stem.	Я слышу твой голос.
Ik hoor jouw stem niet.	Я не слышу твой голос.
Hoor je mijn stem?	Ты слышишь мой голос?
stil	тихий
Het is stil.	Тихо.
Het is niet stil.	Не тихо.
Is het stil?	Тихо?
de stoel	стул
Ik zit op een stoel.	Я сижу на стуле.
Ik zit niet op een stoel.	Я не сижу на стуле.
Zit je op een stoel?	Ты сидишь на стуле?
het stokbrood	багет
Ik koop stokbrood.	Я покупаю багет.
Ik koop geen stokbrood.	Я не покупаю багет.
Koop je stokbrood?	Ты покупаешь багет?
de stroopwafel	сироповый вафли
Ik eet een stroopwafel.	Я ем сироповые вафли.
Ik eet geen stroopwafel.	Я не ем сироповые вафли.
Eet je een stroopwafel?	Ты ешь сироповые вафли?
de stropdas	галстук
Ik draag een stropdas.	Я ношу галстук.
Ik draag geen stropdas.	Я не ношу галстук.
Draag je een stropdas?	Ты носишь галстук?
de suiker	сахар
Ik gebruik suiker.	Я использую сахар.
Ik gebruik geen suiker.	Я не использую сахар.
Gebruik je suiker?	Ты используешь сахар?
de supermarkt	супермаркет
Ik ga naar de supermarkt.	Я пойду в супермаркет.
Ik ga niet naar de supermarkt.	Я не пойду в супермаркет.
Ga je naar de supermarkt?	Ты идёшь в супермаркет?
de taart	торт
Ik eet taart.	Я ем торт.
Ik eet geen taart.	Я не ем торт.
Eet je taart?	Ты ешь торт?
de tafel	стол
Ik zit aan de tafel.	Я сижу за столом.
Ik zit niet aan de tafel.	Я не сижу за столом.
Zit je aan de tafel?	Ты сидишь за столом?
de tas	сумка
Ik draag een tas.	Я ношу сумку.
Ik draag geen tas.	Я не ношу сумку.
Draag je een tas?	Ты носишь сумку?
het tasje	сумочка
Het tasje is klein.	Сумочка маленькая.
Het tasje is niet klein.	Сумочка не маленькая.
Is het tasje klein?	Сумочка маленькая?
de televisie	телевизор
Ik kijk televisie.	Я смотрю телевизор.
Ik kijk geen televisie.	Я не смотрю телевизор.
Kijk je televisie?	Ты смотришь телевизор?
terug	обратно
Ik ga terug.	Я пойду обратно.
Ik ga niet terug.	Я не пойду обратно.
Ga je terug?	Ты идёшь обратно?
de tomaat	помидор
Ik eet een tomaat.	Я ем помидор.
Ik eet geen tomaat.	Я не ем помидор.
Eet je een tomaat?	Ты ешь помидор?
de trui	свитер
Ik draag een trui.	Я ношу свитер.
Ik draag geen trui.	Я не ношу свитер.
Draag je een trui?	Ты носишь свитер?
het T-shirt	футболка
Ik draag een T-shirt.	Я ношу футболку.
Ik draag geen T-shirt.	Я не ношу футболку.
Draag je een T-shirt?	Ты носишь футболку?
de tulp	тюльпан
Ik koop een tulp.	Я покупаю тюльпан.
Ik koop geen tulp.	Я не покупаю тюльпан.
Koop je een tulp?	Ты покупаешь тюльпан?
de ui	лук
Ik gebruik ui.	Я использую лук.
Ik gebruik geen ui.	Я не использую лук.
Gebruik je ui?	Ты используешь лук?
het varkensvlees	свинина
Ik eet varkensvlees.	Я ем свинину.
Ik eet geen varkensvlees.	Я не ем свинину.
Eet je varkensvlees?	Ты ешь свинину?
veel	много
Ik heb veel tijd.	У меня много времени.
Ik heb niet veel tijd.	У меня не много времени.
Heb je veel tijd?	У тебя много времени?
het verband	бинт
Ik gebruik een verband.	Я использую бинт.
Ik gebruik geen verband.	Я не использую бинт.
Gebruik je een verband?	Ты используешь бинт?
de verkoper	продавец
De verkoper helpt mij.	Продавец помогает мне.
De verkoper helpt mij niet.	Продавец не помогает мне.
Helpt de verkoper jou?	Продавец помогает тебе?
verrukkelijk	восхитительный
Het is verrukkelijk.	Это восхитительно.
Het is niet verrukkelijk.	Это не восхитительно.
Is het verrukkelijk?	Это восхитительно?
vers	свежий
Het brood is vers.	Хлеб свежий.
Het brood is niet vers.	Хлеб не свежий.
Is het brood vers?	Хлеб свежий?
verschillend	разный
Ze zijn verschillend.	Они разные.
Ze zijn niet verschillend.	Они не разные.
Zijn ze verschillend?	Они разные?
het vest	жилет
Ik draag een vest.	Я ношу жилет.
Ik draag geen vest.	Я не ношу жилет.
Draag je een vest?	Ты носишь жилет?
de vlaai	пирог
Ik eet vlaai.	Я ем пирог.
Ik eet geen vlaai.	Я не ем пирог.
Eet je vlaai?	Ты ешь пирог?
het vlees	мясо
Ik eet vlees.	Я ем мясо.
Ik eet geen vlees.	Я не ем мясо.
Eet je vlees?	Ты ешь мясо?
de vleeswaren	мясные продукты
Ik koop vleeswaren.	Я покупаю мясные продукты.
Ik koop geen vleeswaren.	Я не покупаю мясные продукты.
Koop je vleeswaren?	Ты покупаешь мясные продукты?
voor	для
Dit is voor jou.	Это для тебя.
Dit is niet voor jou.	Это не для тебя.
Is dit voor jou?	Это для тебя?
warm	тёплый
Het is warm.	Тепло.
Het is niet warm.	Не тепло.
Is het warm?	Тепло?
wat	что
Wat is dit?	Что это?
Wat is dit niet?	Что это не?
Wat is dit?	Что это?
het water	вода
Ik drink water.	Я пью воду.
Ik drink geen water.	Я не пью воду.
Drink je water?	Ты пьёшь воду?
het wc-papier	туалетная бумага
Ik koop wc-papier.	Я покупаю туалетную бумагу.
Ik koop geen wc-papier.	Я не покупаю туалетную бумагу.
Koop je wc-papier?	Ты покупаешь туалетную бумагу?
het weekend	выходные
Ik ga in het weekend.	Я пойду в выходные.
Ik ga niet in het weekend.	Я не пойду в выходные.
Ga je in het weekend?	Ты идёшь в выходные?
weer	снова
Ik kom weer.	Я приду снова.
Ik kom niet weer.	Я не приду снова.
Kom je weer?	Ты придёшь снова?
weinig	мало
Ik heb weinig tijd.	У меня мало времени.
Ik heb niet weinig tijd.	У меня не мало времени.
Heb je weinig tijd?	У тебя мало времени?
de whisky	виски
Ik drink whisky.	Я пью виски.
Ik drink geen whisky.	Я не пью виски.
Drink je whisky?	Ты пьёшь виски?
de wijn	вино
Ik drink wijn.	Я пью вино.
Ik drink geen wijn.	Я не пью вино.
Drink je wijn?	Ты пьёшь вино?
de winkel	магазин
Ik ga naar de winkel.	Я пойду в магазин.
Ik ga niet naar de winkel.	Я не пойду в магазин.
Ga je naar de winkel?	Ты идёшь в магазин?
winkelen	покупать
Ik ga winkelen.	Я пойду покупать.
Ik ga niet winkelen.	Я не пойду покупать.
Ga je winkelen?	Ты идёшь покупать?
de winter	зима
Het is winter.	Зима.
Het is niet winter.	Не зима.
Is het winter?	Зима?
wit	белый
Het papier is wit.	Бумага белая.
Het papier is niet wit.	Бумага не белая.
Is het papier wit?	Бумага белая?
de worst	колбаса
Ik eet worst.	Я ем колбасу.
Ik eet geen worst.	Я не ем колбасу.
Eet je worst?	Ты ешь колбасу?
zacht	мягкий
Het kussen is zacht.	Подушка мягкая.
Het kussen is niet zacht.	Подушка не мягкая.
Is het kussen zacht?	Подушка мягкая?
de zak	мешок
Ik gebruik een zak.	Я использую мешок.
Ik gebruik geen zak.	Я не использую мешок.
Gebruik je een zak?	Ты используешь мешок?
het zakje	пакетик
Het zakje is klein.	Пакетик маленький.
Het zakje is niet klein.	Пакетик не маленький.
Is het zakje klein?	Пакетик маленький?
ziens	видя
Ik zie het.	Я вижу это.
Ik zie het niet.	Я не вижу это.
Zie je het?	Ты видишь это?
de zin	предложение
Ik maak een zin.	Я составляю предложение.
Ik maak geen zin.	Я не составляю предложение.
Maak je een zin?	Ты составляешь предложение?
zoet	сладкий
De appel is zoet.	Яблоко сладкое.
De appel is niet zoet.	Яблоко не сладкое.
Is de appel zoet?	Яблоко сладкое?
de zomer	лето
Het is zomer.	Лето.
Het is niet zomer.	Не лето.
Is het zomer?	Лето?
zonder	без
Ik ga zonder jou.	Я пойду без тебя.
Ik ga niet zonder jou.	Я не пойду без тебя.
Ga je zonder mij?	Ты идёшь без меня?
zout	солёный
Het eten is zout.	Еда солёная.
Het eten is niet zout.	Еда не солёная.
Is het eten zout?	Еда солёная?
zuur	кислый
De citroen is zuur.	Лимон кислый.
De citroen is niet zuur.	Лимон не кислый.
Is de citroen zuur?	Лимон кислый?
zwart	чёрный
Mijn jas is zwart.	Моя куртка чёрная.
Mijn jas is niet zwart.	Моя куртка не чёрная.
Is jouw jas zwart?	Твоя куртка чёрная?

